1111111111111111111111111111111111
100000000000000E00000E000000000001
1010010100100000101001000000010101
1010010010101010001001000000010101
100000000E00E0000000000000000000E1
1000000P0E00E0000000000000000000E1
1111111111111111111111111111111111