1111111111111111111111111111111111111111111111111111111111111111111111111111111111111111111111111111111111111111111111111111111111111111
1E0000000000000C00000C000000000000000C00000C000000000000000C00000C000000000000000C00000C000000000000000C00000C000000000000000C00000C0001
1010010100100000101001000000010010100100000001001010010000000100101001000000010010100100000001001010010000000100101001000000010010100101
1010010010101010001001000000010101010001001000000010101010001001000000010101010001001000000010101010001001000000010101010001001000010101
1010010010101010001001000000010101010001001000000010101010001001000000010101010001001000000010101010001001000000010101010001001000010101
1010010010101010001001000000010101010001001000000010101010001001000000010101010001001000000010101010001001000000010101010001001000010101
1010010010101010001001000000010101010001001000000010101010001001000000010101010001001000000010101010001001000000010101010001001000010101
1010010010101010001001000000010101010001001000000010101010001001000000010101010001001000000010101010001001000000010101010001001000010101
1010010010101010001001000000010101010001001000000010101010001001000000010101010001001000000010101010001001000000010101010001001000010101
1010010010101010001001000000010101010001001000000010101010001001000000010101010001001000000010101010001001000000010101010001001000010101
1010010010101010001001000000010101010001001000000010101010001001000000010101010001001000000010101010001001000000010101010001001000010101
1010010010101010001001000000010101010001001000000010101010001001000000010101010001001000000010101010001001000000010101010001001000010101
1010010010101010001001000000010101010001001000000010101010001001000000010101010001001000000010101010001001000000010101010001001000010101
1010010010101010001001000000010101010001001000000010101010001001000000010101010001001000000010101010001001000000010101010001001000010101
1010010010101010001001000000010101010001001000000010101010001001000000010101010001001000000010101010001001000000010101010001001000010101
1010010010101010001001000000010101010001001000000010101010001001000000010101010001001000000010101010001001000000010101010001001000010101
1010010010101010001001000000010101010001001000000010101010001001000000010101010001001000000010101010001001000000010101010001001000010101
1010010010101010001001000000010101010001001000000010101010001001000000010101010001001000000010101010001001000000010101010001001000010101
1010010010101010001001000000010101010001001000000010101010001001000000010101010001001000000010101010001001000000010101010001001000010101
1010010010101010001001000000010101010001001000000010101010001001000000010101010001001000000010101010001001000000010101010001001000010101
1P0000000C00C0000000000000000000CC0000000000000000000CC0000000000000000000CC0000000000000000000CC0000000000000000000CC000000000000000001
1111111111111111111111111111111111111111111111111111111111111111111111111111111111111111111111111111111111111111111111111111111111111111