1111111111111
10U10000D00C1
1L00011111R01
1P0011E000001
1111111111111