11111111111111111111111
1E00000000R0000C0000UC1
10100101001000001010011
1010010010101L100010011
10100100101010100010011
1P0000000C00C0000000001
11111111111111111111111