11111111111
1P000C00001
10011011001
10011011001
1C011E110C1
10011111U01
10011011001
10U00CL0001
11111111111